t,value
1741050029,0
1741050030,0
1741050031,0
1741050032,0
1741050033,0
1741050034,0
1741050035,0
1741050036,0
1741050037,0
1741050038,0
1741050039,0
1741050040,0
1741050041,0
1741050042,0
1741050043,0
1741050044,0
1741050045,0
1741050046,0
1741050047,0
1741050048,0
1741050049,0
1741050050,0
1741050051,0
1741050052,0
1741050053,0
1741050054,0
1741050055,0
1741050056,0
1741050057,0
1741050058,0
1741050059,0
1741050060,0
1741050061,2
1741050063,4
1741050064,4
1741050065,4
1741050066,4
1741050067,0
1741050068,0
1741050069,3
1741050070,5
1741050071,6
1741050072,5
1741050073,5
1741050074,5
1741050075,4
1741050076,4
1741050077,0
1741050078,0
1741050079,0
1741050079,0
1741050079,0
