t,value
1740830330,0
1740830340,0
1740830350,0
1740830350,0
1740830350,0
